EEEEEEEE*EEEEEEEEEEE
E12yGEEEEE2rEEEREEEE
EE3EEEGGEE1EgEEEEEEE
EEEErEEEERREEEEEE*EE
EEEE3EEYYEE2EyEEEEEE
EEE*EE2E111EEEEEEEEE
EEEEEEEEEEEEEEEEEEEE
