EEE1EEEE*EEEEEEEEE4E
3EEEGEE1EEEE2EEREE44
EE1EEEGGEEEEEEE2EEEE
EEEErEEEERRE2EEEE*EE
E3EEE1EYYEEEEyEEEEEE
EEE*EEEEEEE3EEE1EEEE
EEEE2EEEEEEEEEEEEEEE
